G T G T G T G T G T G T G T G T G T G
T G G G G G G G G G G G G G G G G G T
G G G G G G G G R R R G G G G G G G G
T G G R R R G G R RK R G G R R R G G T
G G G R RQ R R R R R R R R R RQ R G G G
T G G R R G G G G G G G G G R R G G T
G G G G R G G G G G G G G G R G G G G
T G G G R G G G G G G G G G R G G G T
G G G G R G G G G G G G G G R G G G G
T G G G R G G G G G G G G G R G G G T
G G G G R G G G G G G G G G R G G G G
T G G G R G G G G G G G G G R G G G T
G G G G R G G G G G G G G G R G G G G
T G G G R G G G G G G G G G R G G G T
E E E E B E E E E E E E E E B E E E E
W W W W B W W W W W W W W W B W W W W
W W W W B W W W W W W W W W B W W W W
T G G G R G G G G G G G G G R G G G T
G G G G R G G G G G G G G G R G G G G
T G G G R G G G G G G G G G R G G G T
G G G G R G G G G G G G G G R G G G G
T G G G R G G G G G G G G G R G G G T
G G G G R G G G G G G G G G R G G G G
T G G G R G G G G G G G G G R G G G T
G G G G R G G G G G G G G G R G G G G
T G G G R G G G G G G G G G R G G G T
G G G R R G G G G G G G G G R R G G G
T G G R BQ R R R R R R R R R BQ R G G T
G G G R R R G G R BK R G G R R R G G G
T G G G G G G G R R R G G G G G G G T
G G G G G G G G G G G G G G G G G G G
G T G T G T G T G T G T G T G T G T G